19 19 1 2 19 18 18 18
*I*****************
*                 *
*                 *
*                 *
*                 *
*                 *
*                 *
*                 *
*                 *
*                 *
*                 *
*                 *
*                 *
*                 *
*                 *
*                 *
*                 *
*                P*
*****************O*
